11111111
1P0C0E1
10000011
11111111
