11111111111111111111111111111111111
10010000000C00000000000000000000011
100001111100000000000000000C0000011
1P0011E0000000000000000000000000011
11111111111111111111111111111111111
