1111111111111111111111111111111111
10010000000C0000000000000000000001
100001111100000000000000000C000001
1P0011E000000000000000000000000001
1111111111111111111111111111111111
